NO assets/wolfenstein/blue-wall-cage.xpm
SO assets/wolfenstein/blue-wall0.xpm
WE assets/wolfenstein/blue-wall1.xpm
EA assets/wolfenstein/blue-wall-cage-skull.xpm
2_TYPE DOOR
2_DIRECTION NORTH
2_DOOR assets/wolfenstein/door.xpm
2_SIDES assets/wolfenstein/door-frame.xpm
6_TYPE DOOR
6_DIRECTION WEST
6_DOOR assets/wolfenstein/door.xpm
6_SIDES assets/wolfenstein/door-frame.xpm
F 50, 50, 50
C 50, 50, 50

                             111111111111111
                             111111111111111
     111111                  100000000000111111
     100001      111111111111100000000000111111
     1000011     100000000000100000000000100011
     1000001     100000000000600000000000600011
     1000001     100000000000100000000000100011
     11111211111 100011111111100000000000111111
     10000000001 10001       100000000000111111
     1000000000111000111     11111121111111
     1000000000100000001     11111000111111
     1000000000600000001       111000111111
     1000000000100000001       11100011
111111000000000111111111       11100011
1000110000000001           11111110001111
1000111111211111           11111110001111
10001   10001              11006000000011
11211   10001              11001110001111
1000111110001              11001110001111
1000100010001              11001110001111
1000000010001              111111100011
1000100010001              111111100011              111111111111
1000111111211111                 11211               111111111111
1000110000000001           111111000001111111        110000000011
1000110000000001           10000000000000001111111111110000000011
1000110000000001           10000000000000001111111111110000000011
1000010000000001           10000000000000000100000000010000000011
1000060000000001           10000000000000000600000000060000000011
1000010000000001           10000000000000000100000000010000000011
1000110000000001           10000000000000001111000011110000000011
1000110000000001           100000000000000011 1100111110000000011
1000110000000001           111111000001111111 1100111110000000011
1000111111211111                 112111       1100111111111111111
10001   10001                   1100011       1100111111111111111
1000111110001                   1100011       1100111111111111111
1000100010001                   1100011       11001111111111111
1000000010001                   1100011       11001110101010111
1000100010001                   1100011       11000100000000011
1000111110001                   1100011       11000600000000011
100011111000111111111111111     1100011       11000100000000011
100000000000000010000000111     1100011       11111110101010111
100000000000000060000000001     1100011       11111111111111111
100000000000000010000000111     1100011
111111111111111112111111111  111110001111111
        111001006001        1111111211111111
        100001001001       11000010001000011
        111000001111       11000060006000011
          1121111          11000010001000011
           1001            11000010001000011
           1001            11111110001111111
           1111            11000010001000011
                           110S0060006000011
                           11000010001000011
                           11111110001111111
                           11000000000000011
                           11000000000000011
                           11000000000000011
                           11111111111111111