BACKGROUND_SOUND assets/wolf3d/sounds/getthem.mp3
BACKGROUND_SOUND_VOLUME 0.1
BACKGROUND_SOUND_LOOP TRUE

COLLISION_SOUND assets/wolf3d/sounds/hitwall.mp3

HUD TRUE
DEBUG_HUD TRUE
STATUS_HUD TRUE

STATS_HUD_FONT assets/fonts/wolf3d

STATS_HUD_1_SPRITE assets/wolf3d/textures/hud/stats/1-0.xpm:assets/wolf3d/textures/hud/stats/1-1.xpm:assets/wolf3d/textures/hud/stats/1-0.xpm:assets/wolf3d/textures/hud/stats/1-2.xpm
STATS_HUD_1_SPRITE_LOOP TRUE
STATS_HUD_1_SPRITE_UPDATE_DELAY 2

STATS_HUD_2_SPRITE assets/wolf3d/textures/hud/stats/2-0.xpm:assets/wolf3d/textures/hud/stats/2-1.xpm:assets/wolf3d/textures/hud/stats/2-0.xpm:assets/wolf3d/textures/hud/stats/2-2.xpm
STATS_HUD_2_SPRITE_LOOP TRUE
STATS_HUD_2_SPRITE_UPDATE_DELAY 2

STATS_HUD_3_SPRITE assets/wolf3d/textures/hud/stats/3-0.xpm:assets/wolf3d/textures/hud/stats/3-1.xpm:assets/wolf3d/textures/hud/stats/3-0.xpm:assets/wolf3d/textures/hud/stats/3-2.xpm
STATS_HUD_3_SPRITE_LOOP TRUE
STATS_HUD_3_SPRITE_UPDATE_DELAY 2

STATS_HUD_4_SPRITE assets/wolf3d/textures/hud/stats/4-0.xpm:assets/wolf3d/textures/hud/stats/4-1.xpm:assets/wolf3d/textures/hud/stats/4-0.xpm:assets/wolf3d/textures/hud/stats/4-2.xpm
STATS_HUD_4_SPRITE_LOOP TRUE
STATS_HUD_4_SPRITE_UPDATE_DELAY 2

STATS_HUD_5_SPRITE assets/wolf3d/textures/hud/stats/5-0.xpm:assets/wolf3d/textures/hud/stats/5-1.xpm:assets/wolf3d/textures/hud/stats/5-0.xpm:assets/wolf3d/textures/hud/stats/5-2.xpm
STATS_HUD_5_SPRITE_LOOP TRUE
STATS_HUD_5_SPRITE_UPDATE_DELAY 2

STATS_HUD_6_SPRITE assets/wolf3d/textures/hud/stats/6-0.xpm:assets/wolf3d/textures/hud/stats/6-1.xpm:assets/wolf3d/textures/hud/stats/6-0.xpm:assets/wolf3d/textures/hud/stats/6-2.xpm
STATS_HUD_6_SPRITE_LOOP TRUE
STATS_HUD_6_SPRITE_UPDATE_DELAY 2

STATS_HUD_7_SPRITE assets/wolf3d/textures/hud/stats/7-0.xpm:assets/wolf3d/textures/hud/stats/7-1.xpm:assets/wolf3d/textures/hud/stats/7-0.xpm:assets/wolf3d/textures/hud/stats/7-2.xpm
STATS_HUD_7_SPRITE_LOOP TRUE
STATS_HUD_7_SPRITE_UPDATE_DELAY 2


._TYPE BILLBOARD
._HARD TRUE
._SPRITE assets/wolf3d/textures/billboards/blue-plant.xpm

,_TYPE BILLBOARD
,_SPRITE assets/wolf3d/textures/billboards/ceiling-light.xpm

/_TYPE BILLBOARD
/_SPRITE assets/wolf3d/textures/billboards/chandelier.xpm

=_TYPE BILLBOARD
=_HARD TRUE
=_SPRITE assets/wolf3d/textures/billboards/brown-pot.xpm

'_TYPE BILLBOARD
'_HARD TRUE
'_SPRITE assets/wolf3d/textures/billboards/barrel.xpm

?_TYPE BILLBOARD
?_HARD TRUE
?_SPRITE assets/wolf3d/textures/billboards/well.xpm

+_TYPE BILLBOARD
+_HARD TRUE
+_SPRITE assets/wolf3d/textures/billboards/well-water.xpm

-_TYPE BILLBOARD
-_HARD TRUE
-_SPRITE assets/wolf3d/textures/billboards/table.xpm

2_TYPE DOOR
2_DOOR_SPRITE assets/wolf3d/textures/door.xpm
2_SIDES NULL
2_DIRECTION WEST
2_OPEN_SOUND assets/wolf3d/sounds/opendoor.mp3
2_CLOSE_SOUND assets/wolf3d/sounds/closedoor.mp3

3_TYPE DOOR
3_DOOR_SPRITE assets/wolf3d/textures/door.xpm
3_SIDES NULL
3_DIRECTION NORTH
3_OPEN_SOUND assets/wolf3d/sounds/opendoor.mp3
3_CLOSE_SOUND assets/wolf3d/sounds/closedoor.mp3

a_TYPE WALL
a_NO assets/wolf3d/textures/blue-wall1.xpm
a_SO assets/wolf3d/textures/blue-wall0.xpm
a_WE assets/wolf3d/textures/blue-wall1-dark.xpm
a_EA assets/wolf3d/textures/blue-wall0-dark.xpm

b_TYPE WALL
b_NO assets/wolf3d/textures/blue-wall-cage.xpm
b_SO assets/wolf3d/textures/blue-wall-cage.xpm
b_WE assets/wolf3d/textures/blue-wall-cage-dark.xpm
b_EA assets/wolf3d/textures/blue-wall-cage-dark.xpm

c_TYPE WALL
c_NO assets/wolf3d/textures/blue-wall-cage-skull.xpm
c_SO assets/wolf3d/textures/blue-wall-cage-skull.xpm
c_WE assets/wolf3d/textures/blue-wall-cage-skull.xpm
c_EA assets/wolf3d/textures/blue-wall-cage-skull.xpm

d_TYPE WALL
d_NO assets/wolf3d/textures/blue-wall1.xpm
d_SO assets/wolf3d/textures/blue-wall0.xpm
d_WE assets/wolf3d/textures/door-frame.xpm
d_EA assets/wolf3d/textures/door-frame.xpm

e_TYPE WALL
e_NO assets/wolf3d/textures/door-frame.xpm
e_SO assets/wolf3d/textures/door-frame.xpm
e_WE assets/wolf3d/textures/blue-wall1-dark.xpm
e_EA assets/wolf3d/textures/blue-wall0-dark.xpm

f_TYPE WALL
f_NO assets/wolf3d/textures/grey-wall1.xpm
f_SO assets/wolf3d/textures/grey-wall0.xpm
f_WE assets/wolf3d/textures/grey-wall1-dark.xpm
f_EA assets/wolf3d/textures/grey-wall0-dark.xpm

g_TYPE WALL
g_NO assets/wolf3d/textures/eagle-arch.xpm
g_SO assets/wolf3d/textures/eagle-arch.xpm
g_WE assets/wolf3d/textures/eagle-arch-dark.xpm
g_EA assets/wolf3d/textures/eagle-arch-dark.xpm

h_TYPE WALL
h_NO assets/wolf3d/textures/grey-wall-hitler.xpm
h_SO assets/wolf3d/textures/grey-wall-hitler.xpm
h_WE assets/wolf3d/textures/grey-wall-hitler-dark.xpm
h_EA assets/wolf3d/textures/grey-wall-hitler-dark.xpm

i_TYPE WALL
i_NO assets/wolf3d/textures/grey-wall-nazi.xpm
i_SO assets/wolf3d/textures/grey-wall-nazi.xpm
i_WE assets/wolf3d/textures/grey-wall-nazi-dark.xpm
i_EA assets/wolf3d/textures/grey-wall-nazi-dark.xpm

j_TYPE WALL
j_NO assets/wolf3d/textures/wood-wall.xpm
j_SO assets/wolf3d/textures/wood-wall.xpm
j_WE assets/wolf3d/textures/wood-wall-dark.xpm
j_EA assets/wolf3d/textures/wood-wall-dark.xpm

k_TYPE WALL
k_NO assets/wolf3d/textures/wood-wall-eagle.xpm
k_SO assets/wolf3d/textures/wood-wall-eagle.xpm
k_WE assets/wolf3d/textures/door-frame.xpm
k_EA assets/wolf3d/textures/door-frame.xpm

l_TYPE WALL
l_NO assets/wolf3d/textures/wood-wall-eagle.xpm
l_SO assets/wolf3d/textures/wood-wall-eagle.xpm
l_WE assets/wolf3d/textures/wood-wall-eagle-dark.xpm
l_EA assets/wolf3d/textures/wood-wall-eagle-dark.xpm

F 100, 100, 100
C 50, 50, 50

                             111111111111111
                             111111111111111
     111111                  1           111111
     1    1      1111111111111           111111
     1    11     1           e           e   11
     1     1     1 ,    ,    2     /     2   11
     1     1     1           e           e   11
     11113331111 1   111111111           111111
     1         1 1   1       1           111111
     1         111   111     11111d3d111111
     1         e       1         j   j
     1         2   ,   1         j   j
     1         e       1         j , j
111111         111111111         j   j
1   11         1                 j   j
1 , 11111d3d1111            jjjejj   jjj
1   1   1   1               j  2   ,   j
1d3d1   1 , 1               j  ejj   jjj
1   11111   1               j  1 j   j
1 , 1   1   1               j  1 j   j
1     , 1 , 1               jjjj l , l
1   1   1   1                    j   j              
1   11111d3d1111                fjk3kjf              aaaaaaaaaaa
1 , 11         1           ffffif.   .fiffff         a      '''a
1   11         1           f.             .f         aa       'a
1   11  ,   ,  1           g               gaaaaaaaaaaa        a
1    e         1           f                e         e        a
1    2         1           f  /    /    /   2         2        a
1    e         1           f                e         e        a
1   11  ,   ,  1           g               gaaa    aaaa  -  -  a
1   11         1           f.             .f  aa  a   a        a
1   11         1           ffhfff     ffhfff   a  a   a        a
1 , 11111d2d1111                fad3daf        a  aaaaaaa+aa?aaa
1   1   1   1                    a   a         a  a     aaaaaa
1   11111   1                    a , a         a  a
1   1   1   1                    a   a         a  a aaaaaaaaa
1     , 1 , 1                    a   a         a  aaa a a a aa
1   1   1   1                    a   a         a   e         a
1 , 11111   1                    a , a         a   2         b
1   11111   111111111111111      a   a         a   e        =a
1               e       111      a   a         aaaaaa a a a aa
1     ,      ,  2       0 0      a   a             aaaaaaaaaa
1               e       111      a , a
1111111111111111e3111111111      a   a
        111  1  2  1        aaaaaad3daaaaaa
        1    1  e  1        a    e   e    a
        111     1111        a    2 , 2    a
          1d3d111           a    e   e    a
           1  1             a    a   a    a
           1  1             aaaaaa   aaaaaa
           1111             a    e   e    a
                            a E  2 , 2    a
                            a    e   e    a
                            aaaaaa   aaaaaa
                            a             a
                            a  ,   ,   ,  a
                            a             a
                            abaabaacaabaaba