NO assets/wolfenstein/blue-wall-cage.xpm
SO assets/wolfenstein/blue-wall0.xpm
WE assets/wolfenstein/blue-wall1.xpm
EA assets/wolfenstein/blue-wall-cage-skull.xpm

2_TYPE DOOR
2_DIRECTION NORTH
2_DOOR assets/wolfenstein/door.xpm
2_SIDES NULL
3_TYPE WALL
3_SO assets/wolfenstein/blue-wall0.xpm
3_NO assets/wolfenstein/blue-wall-cage.xpm
3_WE assets/wolfenstein/door-frame.xpm
3_EA assets/wolfenstein/door-frame.xpm
6_TYPE DOOR
6_DIRECTION WEST
6_DOOR assets/wolfenstein/door.xpm
6_SIDES NULL
7_TYPE WALL
7_SO assets/wolfenstein/door-frame.xpm
7_NO assets/wolfenstein/door-frame.xpm
7_WE assets/wolfenstein/blue-wall1.xpm
7_EA assets/wolfenstein/blue-wall-cage-skull.xpm

F 50, 50, 50
C 50, 50, 50

                             111111111111111
                             111111111111111
     111111                  100000000000111111
     100001      111111111111100000000000111111
     1000011     100000000000700000000000700011
     1000001     100000000000600000000000600011
     1000001     100000000000700000000000700011
     11113231111 100011111111100000000000111111
     10000000001 10001       100000000000111111
     1000000000111000111     11111323111111
     1000000000700000001     11111000111111
     1000000000600000001       111000111111
     1000000000700000001       11100011
111111000000000111111111       11100011
1000110000000001           11111110001111
1000111113231111           11117110001111
10001   10001              11006000000011
13231   10001              11007110001111
1000111110001              11001110001111
1000100010001              11001110001111
1000000010001              111111100011
1000100010001              111111100011              111111111111
1000111113231111                 13231               111111111111
1000110000000001           111111000001111111        110000000011
1000110000000001           10000000000000001111111111110000000011
1000110000000001           10000000000000001111111111110000000011
1000070000000001           10000000000000000700000000070000000011
1000060000000001           10000000000000000600000000060000000011
1000070000000001           10000000000000000700000000070000000011
1000110000000001           10000000000000001111000011110000000011
1000110000000001           100000000000000011 1100111110000000011
1000110000000001           111111000001111111 1100111110000000011
1000111113231111                 132311       1100111111111111111
10001   10001                   1100011       1100111111111111111
1000111110001                   1100011       1100111111111111111
1000100010001                   1100011       11001111111111111
1000000010001                   1100011       11001110101010111
1000100010001                   1100011       11000700000000011
1000111110001                   1100011       11000600000000011
100011111000111111111111111     1100011       11000700000000011
100000000000000070000000111     1100011       11111110101010111
100000000000000060000000001     1100011       11111111111111111
100000000000000070000000111     1100011
111111111111111172111111111  111110001111111
        111001006001        1111113231111111
        100001007001       11000070007000011
        111000001111       11000060006000011
          1323111          11000070007000011
           1001            11000010001000011
           1001            11111110001111111
           1111            11000070007000011
                           110E0060006000011
                           11000070007000011
                           11111110001111111
                           11000000000000011
                           11000000000000011
                           11000000000000011
                           11111111111111111