NO assets/wolfenstein/grey_stone.xpm
SO assets/wolfenstein/purple_stone.xpm
WE assets/wolfenstein/red_brick.xpm
EA assets/wolfenstein/wood.xpm

F 50,50,50
C 50,50,50

111111
100001
10E001
100001
111111