NO assets/wolf3d/textures/grey-wall0.xpm
SO assets/wolf3d/textures/purple-wall.xpm
WE assets/wolf3d/textures/red-wall.xpm
EA assets/wolf3d/textures/wood-wall.xpm

F 50,50,50
C 225,30,0

111111
1E00W1
100001
1E00W1
111111