NO assets/cashier.xpm
SO assets/cashier.xpm
WE assets/cashier.xpm
EA assets/cashier.xpm
2_TYPE DOOR
2_DIRECTION NORTH
2_DOOR assets/wolfenstein/door.xpm
2_SIDES assets/wolfenstein/door-side.xpm
3_TYPE WALL
3_SO assets/dommigueli.xpm
3_NO NULL
3_WE NULL
3_EA NULL
s_TYPE WALL
s_SO assets/salazar.xpm
s_NO NULL
s_WE assets/wolfenstein/eagle.xpm
s_EA assets/wolfenstein/red_brick.xpm
p_TYPE WALL
p_SO assets/portugal.xpm
p_NO NULL
p_WE NULL
p_EA NULL
MOUSE FALSE

F 46,39,30
C 67,63,1

        11111111111111p1s11131111
        1000000000110000000000001
        1011000001110000000000001
        1001000000000000000002001
111111111011000001110000000000001
100000000011000001110111110111111
11110111111111011100000010001
11110111111111011101010010001
11000000110101011100000010001
10000000000000001100000010000
10000000000000001101010010001
11000001110101011101011110N0111
11110111 1110101 101110000001
11111111 1111111 101110111111